InnerCircle=Effect/Prefabs/InnerCircle
OuterCircle=Effect/Prefabs/OuterCircle
Rectangle=Effect/Prefabs/Rectangle
Sector60=Effect/Prefabs/Sector60
Sector120=Effect/Prefabs/Sector120
Alien=Prefabs/Character/Alien
Bear=Prefabs/Character/Bear
Chemicalman=Prefabs/Character/Chemicalman
Chicken=Prefabs/Character/Chicken
Cowboy=Prefabs/Character/Cowboy
Female=Prefabs/Character/Female
Hero=Prefabs/Character/Hero
Hoodie=Prefabs/Character/Hoodie
Jester=Prefabs/Character/Jester
Knight=Prefabs/Character/Knight
Male=Prefabs/Character/Male
Ninja=Prefabs/Character/Ninja
Robot=Prefabs/Character/Robot
Salaryman=Prefabs/Character/Salaryman
Samurai=Prefabs/Character/Samurai
Sniper=Prefabs/Character/Sniper
Soldier=Prefabs/Character/Soldier
Spaceman=Prefabs/Character/Spaceman
Terrorist=Prefabs/Character/Terrorist
Veteran=Prefabs/Character/Veteran
grasstop_deco=Prefabs/Ground/grasstop_deco
ground_cube=Prefabs/Ground/ground_cube
ground_cube_grass=Prefabs/Ground/ground_cube_grass
sand_cube=Prefabs/Ground/sand_cube
sand_cube_1=Prefabs/Ground/sand_cube_1
sand_cube_2=Prefabs/Ground/sand_cube_2
sand_top=Prefabs/Ground/sand_top
Bullet=Prefabs/SkillFX/Bullet
Bullet1=Prefabs/SkillFX/Bullet1
Plane=Prefabs/SkillFX/Plane
ChoiceHeroPanel=Prefabs/UI/ChoiceHeroPanel
ControlPanel=Prefabs/UI/ControlPanel
GameMainPanel=Prefabs/UI/GameMainPanel
HeroItem=Prefabs/UI/HeroItem
LoginPanel=Prefabs/UI/LoginPanel
MatchPanel=Prefabs/UI/MatchPanel
RegisterPanel=Prefabs/UI/RegisterPanel
StartShowPanel=Prefabs/UI/StartShowPanel
TipPanel=Prefabs/UI/TipPanel
